OOOOOOOOOOOOOUOOOOOOOOOOO
OX    O     O O   O O   O
OOOOO.O O O O OOO . O O O
O     O O O O     O   O O
O OOO O O.O O OOOOOOOOO O
O OOO OOO O OOO . OOO . O
O OOO OOO O OO  O O   O O
OOO   O   O OO OO OOO O O
OO  OOO.OOO    OO OOOOO O
O  OO O OOOOO.OOOO  O O.O
OO.O  O  OO   O   O O   O
OO . OOO OO OOO.O O OO.OO
OO.O O   OO     O O O  OO
O  O O O OO OOO O O O O O
O OO . O OO O O O O O O O
O OO OOO OO O O OOO O O O
O O   O  OO O O .       O
O O   O  .    O OOOO.OO O
O OOOOOOOOOO  O OO   OO O
O .      . O  .  O  OOOOO
O OOOOOOOO   OOOOOOOO   O
O O  .  OOOO   O      O O
O .  O  .  OO  OOOOOOOO.O
O OOOOOOOO  OOOO   O    O
O      OOO  .    O   OO O
OOOOOOOOOOOOOUOOOOOOOOOOO
